11111111111111111111111111111111
101P00001000000000000000000000E1
10101010100000000101000000000001
10101010010000010000000000000001
10001000000100000000000000000001
11111111111111111101000000000001
10000000000000000000000000001001
10000000000000000000000000001001
10000000000000000000000000001001
10000000000000000000000000001001
10000000000000000000000000001001
10000000000000000000000000001CC1
11111111111111111111111111111111
