1111111111111
10010000K0001
1000011111001
1P00P1E000EC1
1111111111111
